{
    "mapName": "Test",
    "tileset": "minecraft.png",
    "width": 256,
    "height": 256,
    "tiles": [2, 2, 2, 2, 2, 2, 2, 2,
              3, 3, 3, 3, 3, 3, 3, 3,
              224, 224, -1, 224, 224, 224, 224, 224,
              224, -1, -1, -1, 224, 224, 224, 224,
              -1, -1, -1, -1, -1, -1, -1, -1,
              -1, -1, -1, -1, -1, -1, -1, -1,
              -1, -1, -1, -1, -1, -1, -1, -1,
              -1, -1, -1, -1, -1, -1, -1, -1]
}
