{
    "mapName": "Test",
    "tileset": "minecraft.png",
    "background": "Background.png",
    "width": 512,
    "height": 320,
    "tiles": [2, 2, 2, 2, 2, 2, 2, 2, 2, 2, -1, -1, 2, 2, 2, 2,
              3, 3, 3, 3, 3, 3, 3, 3, 3, 3, -1, -1, 3, 3, 3, 3,
              224, 224, 224, 225, -1, -1, -1, -1, -1, 224, -1, -1, -1, -1, 224, 224,
              224, 224, 225, -1, -1, -1, -1, -1, -1, 224, -1, -1, -1, -1, -1, 224,
              224, 225, -1, -1, -1, -1, -1, -1, -1, 224, -1, -1, -1, -1, -1, -1,
              12, -1, -1, -1, -1, -1, -1, -1, -1, -1, -1, -1, -1, -1, -1, -1,
              -1, -1, -1, -1, -1, -1, -1, -1, -1, -1, -1, -1, -1, -1, -1, -1,
              -1, -1, -1, -1, -1, -1, -1, -1, -1, -1, -1, -1, -1, -1, -1, -1,
              -1, -1, -1, -1, -1, -1, -1, -1, -1, -1, -1, -1, -1, -1, -1, -1,
              -1, -1, -1, -1, -1, -1, -1, -1, -1, -1, -1, -1, -1, -1, -1, -1]
}
